20
20
00 00 00 00 00 00 00 00 00 00 00 00 00 00 00 00 00 00 00 00 
00 00 00 01 01 01 01 00 01 00 00 00 00 00 00 00 00 00 00 00 
00 00 01 01 01 01 01 01 01 01 00 00 00 00 00 00 00 00 00 00 
00 00 01 01 01 01 01 01 01 01 01 00 00 00 00 00 00 00 00 00 
00 00 00 01 01 11 00 00 11 01 01 01 00 00 00 00 00 00 00 00 
00 00 00 01 01 01 01 06 01 06 01 01 00 00 00 00 00 00 00 00 
00 00 00 01 01 06 01 01 01 06 00 01 00 00 00 00 00 00 00 00 
00 00 00 00 01 06 06 06 06 06 01 01 00 00 00 00 00 00 00 00 
00 00 00 00 00 01 01 01 01 01 01 01 00 00 00 00 00 00 00 00 
00 00 00 00 00 00 00 01 01 01 01 00 00 00 00 00 00 00 00 00 
00 00 00 00 00 00 00 00 00 00 00 00 00 00 00 00 00 00 00 00 
00 00 00 00 00 00 00 00 00 00 00 00 00 00 00 00 00 00 00 00 
00 00 00 00 00 00 00 00 00 00 00 00 00 00 00 00 00 00 00 00 
00 00 00 00 00 00 00 00 00 00 00 00 00 00 00 00 00 00 00 00 
00 00 00 00 00 00 00 00 00 00 00 00 00 00 00 00 00 00 00 00 
00 00 00 00 00 00 00 00 00 00 00 00 00 00 00 00 00 00 00 00 
00 00 00 00 00 00 00 00 00 00 00 00 00 00 00 00 00 00 00 00 
00 00 00 00 00 00 00 00 00 00 00 00 00 00 00 00 00 00 00 00 
00 00 00 00 00 00 00 00 00 00 00 00 00 00 00 00 00 00 00 00 
00 00 00 00 00 00 00 00 00 00 00 00 00 00 00 00 00 00 00 00 
